6,4,4,4,4,4,4,4,4,4,4,4,4,4,4,4,4,4,4,4,4,4,4,4,4,4,4,4,4,5
3,6,4,4,4,4,4,4,4,4,4,4,4,4,5,6,4,4,4,4,4,4,4,4,4,4,4,4,5,3
3,3,1,1,1,1,1,1,1,1,1,1,1,1,3,3,1,1,1,1,1,1,1,1,1,1,1,1,3,3
3,3,1,6,4,4,5,1,6,4,4,4,5,1,3,3,1,6,4,4,4,5,1,6,4,4,5,1,3,3
3,3,1,3,0,0,3,1,3,0,0,0,3,1,3,3,1,3,0,0,0,3,1,3,0,0,3,1,3,3
3,3,1,7,4,4,8,1,7,4,4,4,8,1,7,8,1,7,4,4,4,8,1,7,4,4,8,1,3,3
3,3,1,1,1,1,1,1,1,1,1,1,1,1,1,1,1,1,1,1,1,1,1,1,1,1,1,1,3,3
3,3,1,6,4,4,5,1,6,5,1,6,4,4,4,4,4,4,5,1,6,5,1,6,4,4,5,1,3,3
3,3,1,7,4,4,8,1,3,3,1,7,4,4,5,6,4,4,8,1,3,3,1,7,4,4,8,1,3,3
3,3,1,1,1,1,1,1,3,3,1,1,1,1,3,3,1,1,1,1,3,3,1,1,1,1,1,1,3,3
3,7,4,4,4,4,5,1,3,7,4,4,5,0,3,3,0,6,4,4,8,3,1,6,4,4,4,4,8,3
3,0,0,0,0,0,3,1,3,6,4,4,8,0,7,8,0,7,4,4,5,3,1,3,0,0,0,0,0,3
3,0,0,0,0,0,3,1,3,3,0,0,0,0,0,0,0,0,0,0,3,3,1,3,0,0,0,0,0,3
8,0,0,0,0,0,3,1,3,3,0,6,4,4,9,9,4,4,5,0,3,3,1,3,0,0,0,0,0,7
4,4,4,4,4,4,8,1,7,8,0,3,0,0,0,0,0,0,3,0,7,8,1,7,4,4,4,4,4,4
10,0,0,0,0,0,0,1,0,0,0,3,0,0,0,0,0,0,3,0,0,0,1,0,0,0,0,0,0,11
4,4,4,4,4,4,5,1,6,5,0,3,0,0,0,0,0,0,3,0,6,5,1,6,4,4,4,4,4,4
5,0,0,0,0,0,3,1,3,3,0,7,4,4,4,4,4,4,8,0,3,3,1,3,0,0,0,0,0,6
3,0,0,0,0,0,3,1,3,3,0,0,0,0,0,0,0,0,0,0,3,3,1,3,0,0,0,0,0,3
3,0,0,0,0,0,3,1,3,3,0,6,4,4,4,4,4,4,5,0,3,3,1,3,0,0,0,0,0,3
3,6,4,4,4,4,8,1,7,8,0,7,4,4,5,6,4,4,8,0,7,8,1,7,4,4,4,4,5,3
3,3,1,1,1,1,1,1,1,1,1,1,1,1,3,3,1,1,1,1,1,1,1,1,1,1,1,1,3,3
3,3,1,6,4,4,5,1,6,4,4,4,5,1,3,3,1,6,4,4,4,5,1,6,4,4,5,1,3,3
3,3,1,7,4,5,3,1,7,4,4,4,8,1,7,8,1,7,4,4,4,8,1,3,6,4,8,1,3,3
3,3,1,1,1,3,3,1,1,1,1,1,1,1,1,1,1,1,1,1,1,1,1,3,3,1,1,1,3,3
3,7,4,5,1,3,3,1,6,5,1,6,4,4,4,4,4,4,5,1,6,5,1,3,3,1,6,4,8,3
3,6,4,8,1,7,8,1,3,3,1,7,4,4,5,6,4,4,8,1,3,3,1,7,8,1,7,4,5,3
3,3,1,1,1,1,1,1,3,3,1,1,1,1,3,3,1,1,1,1,3,3,1,1,1,1,1,1,3,3
3,3,1,6,4,4,4,4,8,7,4,4,5,1,3,3,1,6,4,4,8,7,4,4,4,4,5,1,3,3
3,3,1,7,4,4,4,4,4,4,4,4,8,1,7,8,1,7,4,4,4,4,4,4,4,4,8,1,3,3
3,3,1,1,1,1,1,1,1,1,1,1,1,1,1,1,1,1,1,1,1,1,1,1,1,1,1,1,3,3
3,7,4,4,4,4,4,4,4,4,4,4,4,4,4,4,4,4,4,4,4,4,4,4,4,4,4,4,8,3
7,4,4,4,4,4,4,4,4,4,4,4,4,4,4,4,4,4,4,4,4,4,4,4,4,4,4,4,4,8